10 10
S#########
####T##X##
#M#####X##
#######X##
####XXXX##
#X########
#X##K###C#
#X####F###
##########
######B###.