10 10 
S######### 
####T##X## 
#M#####X##  
#######X## 
####XXXX## 
#X######## 
#X######C# 
#XK###F### 
########## 
######B###.